# # . # # . # # . . . . . . . . . . . . . . . . . . . . . . . . . . . . . . . . . . . . . . . . . . . . . . . . . . . . . . . . . . . . . . . . . . . . . . . . . . . . . . . . . . . . . . . . . . . . . . . . . . . . . . . . . . . . . . . . . . . . . . . . . . . . . . . . . . . . . . . . . . . . . . . . . . . . . . . . . . . . . . . . . . . . . . . . . . . . . . . . . . . . . . . . . . . . . . . . . . . . . . . . . . . . . . . . . . . . . . . . . . .
# # . # # . # # . . . . . . . . . . . . . . . . . . . . . . . . . . . . . . . . . . . . . . . . . . . . . . . . . . . . . . . . . . . . . . . . . . . . . . . . . . . . . . . . . . . . . . . . . . . . . . . . . . . . . . . . . . . . . . . . . . . . . . . . . . . . . . . . . . . . . . . . . . . . . . . . . . . . . . . . . . . . . . . . . . . . . . . . . . . . . . . . . . . . . . . . . . . . . . . . . . . . . . . . . . . . . . . . . . . . . . . . . . .
# # . # # . # # . . . . . . . . . . . . . . . . . . . . . . . . . . . . . . . . . . . . . . . . . . . . . . . . . . . . . . . . . . . . . . . . . . . . . . . . . . . . . . . . . . . . . . . . . . . . . . . . . . . . . . . . . . . . . . . . . . . . . . . . . . . . . . . . . . . . . . . . . . . . . . . . . . . . . . . . . . . . . . . . . . . . . . . . . . . . . . . . . . . . . . . . . . . . . . . . . . . . . . . . . . . . . . . . . . . . . . . . . . .
# # . # # . # # . . . . . . . . . . . . . . . . . . . . . . . . . . . . . . . . . . . . . . . . . . . . . . . . . . . . . . . . . . . . . . . . . . . . . . . . . . . . . . . . . . . . . . . . . . . . . . . . . . . . . . . . . . . . . . . . . . . . . . . . . . . . . . . . . . . . . . . . . . . . . . . . . . . . . . . . . . . . . . . . . . . . . . . . . . . . . . . . . . . . . . . . . . . . . . . . . . . . . . . . . . . . . . . . . . . . . . . . . . .
# # . # # . # # . # # . . . . # # . # # . # # . # # . . . . # # . # # . # # . # # . . . . # # . # # . # # . # # . . # . # # . # # . # # . # # . . # . # # . # # . # # . # # . . . . . # # . # . # . # . # . # . # . # . # . # . # . # . # . # . # . # . . . . . . . . . . . . . . . . . . . . . . . . . . . . . . . . . . . . . . . . . . . . . . . . . . . . . . . . . . . . . . . . . . . . . . . . . . . . . . . . . . . . . . . . . . . . . . . . . . . . . . . .
# # . # # . # # . # # . # # . # # . # # . # # . # # . # # . # # . # # . # # . # # . # # . # # . # # . # # . # # . # # . # # . # # . # # . # # . # # . # # . # # . # # . # # . # # . . # # . # . # . # . # . # . # . # . # . # . # . # . # . # . # . # . . . . . . . . . . . . . . . . . . . . . . . . . . . . . . . . . . . . . . . . . . . . . . . . . . . . . . . . . . . . . . . . . . . . . . . . . . . . . . . . . . . . . . . . . . . . . . . . . . . . . . . .
# # . # # . # # . # # . # # . # # . # # . # # . # # . # # . # # . # # . # # . # # . # # . # # . # # . # # . # # . # # . # # . # # . # # . # # . # # . # # . # # . # # . # # . # # . . # # . # . # . # . # . # . # . # . # . # . # . # . # . # . # . # . . . . . . . . . . . . . . . . . . . . . . . . . . . . . . . . . . . . . . . . . . . . . . . . . . . . . . . . . . . . . . . . . . . . . . . . . . . . . . . . . . . . . . . . . . . . . . . . . . . . . . . .
# # . # # . # # . # # . # # . # # . # # . # # . # # . # # . # # . # # . # # . # # . # # . # # . # # . # # . # # . # # . # # . # # . # # . # # . # # . # # . # # . # # . # # . # # . . # # . # . # . # . # . # . # . # . # . # . # . # . # . # . # . # . . . . . . . . . . . . . . . . . . . . . . . . . . . . . . . . . . . . . . . . . . . . . . . . . . . . . . . . . . . . . . . . . . . . . . . . . . . . . . . . . . . . . . . . . . . . . . . . . . . . . . . .
. . . . . . . . . . . . . . . . . . . . . . . . . . . . . . . . . . . . . . . . . . . . . . . . . . . . . . . . . . . . . . . . . . . . . . . . . . . . . . . . . . . . . . . . . . . . . . . . . . . . . . . . . . . . . . . . . . . . . . . . . . . . . . . . . . . . . . . . . . . . . . . . . . . . . . . . . . . . . . . . . . . . . . . . . . . . . . . . . . . . . . . . . . . . . . . . . . . . . . . . . . . . . . . . . . . . . . . . . . . . . . . . . . .
# # . # # . # # . # # . # # . # # . # # . # # . # # . # # . # # . # # . # # . # # . # # . # # . # # . # # . # # . # # . # # . # # . # # . # # . # # . # # . # # . # # . # # . # # . . # # . # # . # # . # # . # # . # # . # # . # # . # # . # # . . # # . # # . # # . # # . # # . # # . # # . # # . # # . . # # . # # . # # . # # . # # . # # . # # . # # . # # . # # . # # . . . . . . . . . # # # . . . # # . . . # # . . . # # . . . # # . . . # # . . . # # . . #
# # . # # . # # . # # . # # . # # . # # . # # . # # . # # . # # . # # . # # . # # . # # . # # . # # . # # . # # . # # . # # . # # . # # . # # . # # . # # . # # . # # . # # . # # . . # # . # # . # # . # # . # # . # # . # # . # # . # # . # # . . # # . # # . # # . # # . # # . # # . # # . # # . # # . . # # . # # . # # . # # . # # . # # . # # . # # . # # . # # . # # . . . . . . . . . # # # . . . # # . . . # # . . . # # . . . # # . . . # # . . . # # . . #
# # . # # . # # . # # . # # . # # . # # . # # . # # . # # . # # . # # . # # . # # . # # . # # . # # . # # . # # . # # . # # . # # . # # . # # . # # . # # . # # . # # . # # . # # . . # # . # # . # # . # # . # # . # # . # # . # # . # # . # # . . # # . # # . # # . # # . # # . # # . # # . # # . # # . . # # . # # . # # . # # . # # . # # . # # . # # . # # . # # . # # . . . . . . . . . # # # . . . # # . . . # # . . . # # . . . # # . . . # # . . . # # . . #
# # . # # . # # . # # . # # . # # . # # . # # . # # . # # . # # . # # . # # . # # . # # . # # . # # . # # . # # . # # . # # . # # . # # . # # . # # . # # . # # . # # . # # . # # . . # # . # # . # # . # # . # # . # # . # # . # # . # # . # # . . # # . # # . # # . # # . # # . # # . # # . # # . # # . . # # . # # . # # . # # . # # . # # . # # . # # . # # . # # . # # . . . . . . . . . # # # . . . # # . . . # # . . . # # . . . # # . . . # # . . . # # . . #
# # . # # . # # . # # . # # . # # . # # . # # . # # . # # . # # . # # . # # . # # . # # . # # . # # . # # . # # . # # . # # . # # . # # . # # . # # . # # . # # . # # . # # . # # . . # # . # # . # # . # # . # # . # # . # # . # # . # # . # # . . # # . # # . # # . # # . # # . # # . # # . # # . # # . . # # . # # . # # . # # . # # . # # . # # . # # . # # . # # . # # . . . . . . . . . # # # . . . # # . . . # # . . . # # . . . # # . . . # # . . . # # . . #
# # . # # . # # . # # . # # . # # . # # . # # . # # . # # . # # . # # . # # . # # . # # . # # . # # . # # . # # . # # . # # . # # . # # . # # . # # . # # . # # . # # . # # . # # . . # # . # # . # # . # # . # # . # # . # # . # # . # # . # # . . # # . # # . # # . # # . # # . # # . # # . # # . # # . . # # . # # . # # . # # . # # . # # . # # . # # . # # . # # . # # . . . . . . . . . # # # . . . # # . . . # # . . . # # . . . # # . . . # # . . . # # . . #
# # . # # . # # . # # . # # . # # . # # . # # . # # . # # . # # . # # . # # . # # . # # . # # . # # . # # . # # . # # . # # . # # . # # . # # . # # . # # . # # . # # . # # . # # . . # # . # # . # # . # # . # # . # # . # # . # # . # # . # # . . # # . # # . # # . # # . # # . # # . # # . # # . # # . . # # . # # . # # . # # . # # . # # . # # . # # . # # . # # . # # . . . . . . . . . # # # . . . # # . . . # # . . . # # . . . # # . . . # # . . . # # . . #
# # . # # . # # . # # . . . . # # . # # . # # . # # . . . . # # . # # . # # . # # . . . . # # . # # . # # . # # . . . . # # . # # . # # . # # . . . . # # . # # . # # . # # . . . . . # # . # # . # # . # # . . # . # # . # # . # # . # # . . # . . # # . # # . # # . # . . # # . # # . # # . # # . # . . . # # . # # . # # . # # . . # . # # . # # . # # . # # . . # . # # . . . . . . . . . # # # . . . # # . . . . . . . . # # . . . # # . . . . # . . . # # . . #
. . . . . . . . . . . . . . . . . . . . . . . . . . . . . . . . . . . . . . . . . . . . . . . . . . . . . . . . . . . . . . . . . . . . . . . . . . . . . . . . . . . . . . . . . . . . . . . . . . . . . . . . . . . . . . . . . . . . . . . . . . . . . . . . . . . . . . . . . . . . . . . . . . . . . . . . . . . . . . . . . . . . . . . . . . . . . . . . . . . . . . . . . . . . . . . . . . . . . . . . . . . . . . . . . . . . . . . . . . . . . . . . . . .
. . . . . . . . . . . . . . . . . . . . . . . . . . . . . . . . . . . . . . . . . . . . . . . . . . . . . . . . . . . . . . . . . . . . . . . . . . . . . . . . . . . . . . . . . . . . . . . . . . . . . . . . . . . . . . . . . . . . . . . . . . . . . . . . . . . . . . . . . . . . . . . . . . . . . . . . . . . . . . . . . . . . . . . . . . . . . . . . . . . . . . . . . . . . . . . # # # . . . # # . . . # # . . . # # . . . # # . . . # # . . . # # . . #
# # . # # . # # . # # . # # . # # . # # . # # . # # . # # . # # . # # . # # . # # . # # . # # . # # . # # . # # . # # . # # . # # . # # . # # . # # . # # . # # . # # . # # . # # . . # # . # # . # # . # # . # # . # # . # # . # # . # # . # # . . # # . # # . # # . # # . # # . # # . # # . # # . # # . . # # . # # . # # . # # . # # . # # . # # . # # . # # . # # . # # . . . . . . . . . # # # . . . # # . . . # # . . . # # . . . # # . . . # # . . . # # . . #
# # . # # . # # . # # . # # . # # . # # . # # . # # . # # . # # . # # . # # . # # . # # . # # . # # . # # . # # . # # . # # . # # . # # . # # . # # . # # . # # . # # . # # . # # . . # # . # # . # # . # # . # # . # # . # # . # # . # # . # # . . # # . # # . # # . # # . # # . # # . # # . # # . # # . . # # . # # . # # . # # . # # . # # . # # . # # . # # . # # . # # . . . . . . . . . # # # . . . # # . . . # # . . . # # . . . # # . . . # # . . . # # . . #
# # . # # . # # . # # . # # . # # . # # . # # . # # . # # . # # . # # . # # . # # . # # . # # . # # . # # . # # . # # . # # . # # . # # . # # . # # . # # . # # . # # . # # . # # . . # # . # # . # # . # # . # # . # # . # # . # # . # # . # # . . # # . # # . # # . # # . # # . # # . # # . # # . # # . . # # . # # . # # . # # . # # . # # . # # . # # . # # . # # . # # . . . . . . . . . # # # . . . # # . . . # # . . . # # . . . # # . . . # # . . . # # . . #
# # . # # . # # . # # . # # . # # . # # . # # . # # . # # . # # . # # . # # . # # . # # . # # . # # . # # . # # . # # . # # . # # . # # . # # . # # . # # . # # . # # . # # . # # . . # # . # # . # # . # # . # # . # # . # # . # # . # # . # # . . # # . # # . # # . # # . # # . # # . # # . # # . # # . . # # . # # . # # . # # . # # . # # . # # . # # . # # . # # . # # . . . . . . . . . # # # . . . # # . . . # # . . . # # . . . # # . . . # # . . . # # . . #
# # . # # . # # . # # . # # . # # . # # . # # . # # . # # . # # . # # . # # . # # . # # . # # . # # . # # . # # . # # . # # . # # . # # . # # . # # . # # . # # . # # . # # . # # . . # # . # # . # # . # # . # # . # # . # # . # # . # # . # # . . # # . # # . # # . # # . # # . # # . # # . # # . # # . . # # . # # . # # . # # . # # . # # . # # . # # . # # . # # . # # . . . . . . . . . # # # . . . # # . . . # # . . . # # . . . # # . . . # # . . . # # . . #
# # . # # . # # . # # . # # . # # . # # . # # . # # . # # . # # . # # . # # . # # . # # . # # . # # . # # . # # . # # . # # . # # . # # . # # . # # . # # . # # . # # . # # . # # . . # # . # # . # # . # # . # # . # # . # # . # # . # # . # # . . # # . # # . # # . # . . # # . # # . # # . # # . # . . . # # . # # . # # . # # . . # . # # . # # . # # . # # . . # . # # . . . . . . . . . . . . . . . . . . . . . . . . . . . . . . . . . . . . . . . . . . . . .
# # . # # . # # . # # . # # . # # . # # . # # . # # . # # . # # . # # . # # . # # . # # . # # . # # . # # . # # . # # . # # . # # . # # . # # . # # . # # . # # . # # . # # . # # . . # # . # # . # # . # # . # # . # # . # # . # # . # # . # # . . # # . # # . # # . # # . # # . # # . # # . # # . # # . . # # . # # . # # . # # . # # . # # . # # . # # . # # . # # . # # . . . . . . . . . . . . . . . . . . . . . . . . . . . . . . . . . . . . . . . . . . . . #
# # . # # . # # . # # . # # . # # . # # . # # . # # . # # . # # . # # . # # . # # . # # . # # . # # . # # . # # . # # . # # . # # . # # . # # . # # . # # . # # . # # . # # . # # . . # # . # # . # # . # # . # # . # # . # # . # # . # # . # # . . # # . # # . # # . # # . # # . # # . # # . # # . # # . . # # . # # . # # . # # . # # . # # . # # . # # . # # . # # . # # . . . . . . . . . # # # . . . # # . . . # # . . . # # . . . # # . . . # # . . . # # . . #
# # . # # . # # . # # . # # . # # . # # . # # . # # . # # . # # . # # . # # . # # . # # . # # . # # . # # . # # . # # . # # . # # . # # . # # . # # . # # . # # . # # . # # . # # . . # # . # # . # # . # # . # # . # # . # # . # # . # # . # # . . # # . # # . # # . # # . # # . # # . # # . # # . # # . . # # . # # . # # . # # . # # . # # . # # . # # . # # . # # . # # . . . . . . . . . # # # . . . # # . . . # # . . . # # . . . # # . . . # # . . . # # . . #
# # . # # . # # . # # . # # . # # . # # . # # . # # . # # . # # . # # . # # . # # . # # . # # . # # . # # . # # . # # . # # . # # . # # . # # . # # . # # . # # . # # . # # . # # . . # # . # # . # # . # # . # # . # # . # # . # # . # # . # # . . # # . # # . # # . # # . # # . # # . # # . # # . # # . . # # . # # . # # . # # . # # . # # . # # . # # . # # . # # . # # . . . . . . . . . # # # . . . # # . . . # # . . . # # . . . # # . . . # # . . . # # . . #
# # . # # . # # . # # . # # . # # . # # . # # . # # . # # . # # . # # . # # . # # . # # . # # . # # . # # . # # . # # . # # . # # . # # . # # . # # . # # . # # . # # . # # . # # . . # # . # # . # # . # # . # # . # # . # # . # # . # # . # # . . # # . # # . # # . # # . # # . # # . # # . # # . # # . . # # . # # . # # . # # . # # . # # . # # . # # . # # . # # . # # . . . . . . . . . # # # . . . # # . . . # # . . . # # . . . # # . . . # # . . . # # . . #
# # . # # . # # . # # . . . . # # . # # . # # . # # . . . . # # . # # . # # . # # . . . . # # . # # . # # . # # . . . . # # . # # . # # . # # . . . . # # . # # . # # . # # . . . . . # # . # # . # # . # # . . # . # # . # # . # # . # # . . # . . # # . # # . # # . # # . # # . # # . # # . # # . # # . . # # . # # . # # . # # . # # . # # . # # . # # . # # . # # . # # . . . . . . . . . # # # . . . # # . . . # # . . . # # . . . # # . . . # # . . . # # . . #
. . . . . . . . . . . . . . . . . . . . . . . . . . . . . . . . . . . . . . . . . . . . . . . . . . . . . . . . . . . . . . . . . . . . . . . . . . . . . . . . . . . . . . . . . . . . . . . . . . . . . . . . . . . . . . . . . . . . . . . . . . . . . . . . . . . . . . . . . . . . . . . . . . . . . . . . . . . . . . . . . . . . . . . . . . . . . . . . . . . . . . . . . . . . . . . . . . . . . . . . . . . . . . . . . . . . . . . . . . . . . . . . . . .
. . . . . . . . . . . . . . . . . . . . . . . . . . . . . . . . . . . . . . . . . . . . . . . . . . . . . . . . . . . . . . . . . . . . . . . . . . . . . . . . . . . . . . . . . . . . . . . . . . . . . . . . . . . . . . . . . . . . . . . . . . . . . . . . . . . . . . . . . . . . . . . . . . . . . . . . . . . . . . . . . . . . . . . . . . . . . . . . . . . . . . . . . . . . . . . . . . . . . . . . . . . . . . . . . . . . . . . . . . . . . . . . . . .
. . . . . . . . . . . . . . . . . . . . . . . . . . . . . . . . . . . . . . . . . . . . . . . . . . . . . . . . . . . . . . . . . . . . . . . . . . . . . . . . . . . . . . . . . . . . . . . . . . . . . . . . . . . . . . . . . . . . . . . . . . . . . . . . . . . . . . . . . . . . . . . . . . . . . . . . . . . . . . . . . . . . . . . . . . . . . . . . . . . . . . . . . . . . . . . . . . . . . . . . . . . . . . . . . . . . . . . . . . . . . . . . . . .
# # . # # . # # . # # . # # . # # . # # . # # . # # . # # . # # . # # . # # . # # . # # . # # . # # . # # . # # . # # . # # . # # . # # . # # . # # . # # . # # . # # . # # . # # . . # # . # # . # # . # # . # # . # # . # # . # # . # # . # # . . # # . # # . # # . # # . # # . # # . # # . # # . # # . . # # . # # . # # . # # . # # . # # . # # . # # . # # . # # . # # . . . . . . . . . . # . # . # . # . # . # . # . # . # . # . # . # . # . # . # . # . # . #
# # . # # . # # . # # . # # . # # . # # . # # . # # . # # . # # . # # . # # . # # . # # . # # . # # . # # . # # . # # . # # . # # . # # . # # . # # . # # . # # . # # . # # . # # . . # # . # # . # # . # # . # # . # # . # # . # # . # # . # # . . # # . # # . # # . # # . # # . # # . # # . # # . # # . . # # . # # . # # . # # . # # . # # . # # . # # . # # . # # . # # . . . . . . . . . . # . # . # . # . # . # . # . # . # . # . # . # . # . # . # . # . # . #
# # . # # . # # . # # . # # . # # . # # . # # . # # . # # . # # . # # . # # . # # . # # . # # . # # . # # . # # . # # . # # . # # . # # . # # . # # . # # . # # . # # . # # . # # . . # # . # # . # # . # # . # # . # # . # # . # # . # # . # # . . # # . # # . # # . # # . # # . # # . # # . # # . # # . . # # . # # . # # . # # . # # . # # . # # . # # . # # . # # . # # . . . . . . . . . . # . # . # . # . # . # . # . # . # . # . # . # . # . # . # . # . # . #
# # . # # . # # . # # . . . . # # . # # . # # . # # . . . . # # . # # . # # . # # . . . . # # . # # . # # . # # . . # . # # . # # . # # . # # . . # . # # . # # . # # . # # . . . . . # # . # # . # # . # # . . # . # # . # # . # # . # # . . # . . # # . # # . # # . # . . # # . # # . # # . # # . # . . . # # . # # . # # . # # . . # . # # . # # . . . . . . . . . . # # . . . . . . . . . . # . # . # . # . # . # . # . # . # . # . # . # . # . # . # . # . # . #
# # . # # . # # . # # . # # . # # . # # . # # . # # . # # . # # . # # . # # . # # . # # . # # . # # . # # . # # . # # . # # . # # . # # . # # . # # . # # . # # . # # . # # . # # . . # # . # # . # # . # # . # # . # # . # # . # # . # # . # # . . # # . # # . # # . # # . # # . # # . # # . # # . # # . . # # . # # . # # . # # . # # . # # . # # . # # . # # . # # . # # . . . . . . . . . . # . # . # . # . # . # . # . # . # . # . # . # . # . # . # . # . # . #
# # . # # . # # . # # . # # . # # . # # . # # . # # . # # . # # . # # . # # . # # . # # . # # . # # . # # . # # . # # . # # . # # . # # . # # . # # . # # . # # . # # . # # . # # . . # # . # # . # # . # # . # # . # # . # # . # # . # # . # # . . # # . # # . # # . # # . # # . # # . # # . # # . # # . . # # . # # . # # . # # . # # . # # . # # . # # . # # . # # . # # . . . . . . . . . . # . # . # . # . # . # . # . # . # . # . # . # . # . # . # . # . # . #
# # . # # . # # . # # . # # . # # . # # . # # . # # . # # . # # . # # . # # . # # . # # . # # . # # . # # . # # . # # . # # . # # . # # . # # . # # . # # . # # . # # . # # . # # . . # # . # # . # # . # # . # # . # # . # # . # # . # # . # # . . # # . # # . # # . # # . # # . # # . # # . # # . # # . . # # . # # . # # . # # . # # . # # . # # . # # . # # . # # . # # . . . . . . . . . . # . # . # . # . # . # . # . # . # . # . # . # . # . # . # . # . # . #
# # . # # . # # . # # . # # . # # . # # . # # . # # . # # . # # . # # . # # . # # . # # . # # . # # . # # . # # . # # . # # . # # . # # . # # . # # . # # . # # . # # . # # . # # . . # # . # # . # # . # # . # # . # # . # # . # # . # # . # # . . # # . # # . # # . # # . # # . # # . # # . # # . # # . . # # . # # . # # . # # . # # . # # . # # . # # . # # . # # . # # . . . . . . . . . . # . # . # . # . # . # . # . # . # . # . # . # . # . # . # . # . # . #
# # . # # . # # . # # . # # . # # . # # . # # . # # . # # . # # . # # . # # . # # . # # . # # . # # . # # . # # . # # . # # . # # . # # . # # . # # . # # . # # . # # . # # . # # . . . . . . . . . . . . . . . . . . . . . . . . . . . . . . . . . . . . . . . . . . . . . . . . . . . . . . . . . . . . . . . . . . . . . . . . . . . . . . . . . . . . . . . . . . . . . . . . . . . . . . . . . . . . . . . . . . . . . . . . . . . . . . . . . . . . . . . . . .
# # . # # . # # . # # . # # . # # . # # . # # . # # . # # . # # . # # . # # . # # . # # . # # . # # . # # . # # . # # . # # . # # . # # . # # . # # . # # . # # . # # . # # . # # . . . . . . . . . . . . . . . . . . . . . . . . . . . . . . . . . . . . . . . . . . . . . . . . . . . . . . . . . . . . . . . . . . . . . . . . . . . . . . . . . . . . . . . . . . . . . . . . . . . . . . . . . . . . . . . . . . . . . . . . . . . . . . . . . . . . . . . . . .
. . . . . . . . . . . . . . . . . . . . . . . . . . . . . . . . . . . . . . . . . . . . . . . . . . . . . . . . . . . . . . . . . . . . . . . . . . . . . . . . . . . . . . . . . . . . . . . . . . . . . . . . . . . . . . . . . . . . . . . . . . . . . . . . . . . . . . . . . . . . . . . . . . . . . . . . . . . . . . . . . . . . . . . . . . . . . . . . . . . . . . . . . . . . . . . . . . . . . . . . . . . . . . . . . . . . . . . . . . . . . . . . . . .
. . . . . . . . . . . . . . . . . . . . . . . . . . . . . . . . . . . . . . . . . . . . . . . . . . . . . . . . . . . . . . . . . . . . . . . . . . . . . . . . . . . . . . . . . . . . . . . . . . . . . . . . . . . . . . . . . . . . . . . . . . . . . . . . . . . . . . . . . . . . . . . . . . . . . . . . . . . . . . . . . . . . . . . . . . . . . . . . . . . . . . . . . . . . . . . . . . . . . . . . . . . . . . . . . . . . . . . . . . . . . . . . . . .
. . . . . . . . . . . . . . . . . . . . . . . . . . . # . # . # . # . # . # . # . # . # . # . # . # . # . # . # . # . # . # . # . # . # . # . # . # . # . # . # . # . # . # . # . # . # . # . # . # . # . # . # . # . # . # . # . # . # . # . . . . . . . . . . . . . . . . . . . . . . . . . . . . . . . . . . . . . . . . . . . . . . . . . . . . . . . . . . . . . . . . . . . . . . . . . . . . . . . . . . . . . . . . . . . . . . . . . . . . . . . . . . . . .
. . . . . . . . . . . . . . . . . . . . . . . . . . . # . # . # . # . # . # . # . # . # . # . # . # . # . # . # . # . # . # . # . # . # . # . # . # . # . # . # . # . # . # . # . # . # . # . # . # . # . # . # . # . # . # . # . # . # . # . . . . . . . . . . . . . . . . . . . . . . . . . . . . . . . . . . . . . . . . . . . . . . . . . . . . . . . . . . . . . . . . . . . . . . . . . . . . . . . . . . . . . . . . . . . . . . . . . . . . . . . . . . . . .
. . . . . . . . . . . . . . . . . . . . . . . . . . . # . # . # . # . # . # . # . # . # . # . # . # . # . # . # . # . # . # . # . # . # . # . # . # . # . # . # . # . # . # . # . # . # . # . # . # . # . # . # . # . # . # . # . # . # . # . . . . . . . . . . . . . . . . . . . . . . . . . . . . . . . . . . . . . . . . . . . . . . . . . . . . . . . . . . . . . . . . . . . . . . . . . . . . . . . . . . . . . . . . . . . . . . . . . . . . . . . . . . . . .
. . . . . . . . . . . . . . . . . . . . . . . . . . . # . # . # . # . # . # . # . # . # . # . # . # . # . # . # . # . # . # . # . # . # . # . # . # . # . # . # . # . # . # . # . # . # . # . # . # . # . # . # . # . # . # . # . # . # . # . . . . . . . . . . . . . . . . . . . . . . . . . . . . . . . . . . . . . . . . . . . . . . . . . . . . . . . . . . . . . . . . . . . . . . . . . . . . . . . . . . . . . . . . . . . . . . . . . . . . . . . . . . . . .