# # . # # . # # . . . . . . . . . . . . . . . . . . . . . . . . . . . . . . . . . . . . . . . . . . . . . . . . . . . . . . . . . . . . . . . . . . . . . . . . . . . . . . . . . . . . . . . . . . . . . . . . . . . . . . . . . . . . . . . . . . . . . . . . . . . . . . . . . . . . . . . . . . . . . # # . # # . # # . # # . # # . # # . # # . # # . # # . # # . # # . # # . # # . # # . # # . # # . # # . # # . # # . # # . # # . # # . # # . # # . # # . # # . # # . # # . # # . .
# # . # # . # # . # # . # . # . # . # . . . . . . . . . . . . . . . . . . . . . . . . . . . . . . . . . . . . . . . . . . . . . . . . . . . . . . . . . . . . . . . . . . . . . . . . . . . . . . . . . . . . . . . . . . . . . . . . . . . . . . . . . . . . . . . . . . . . . . . . . . . . . . . . . . # # . # # . # # . # # . # # . # # . # # . # # . # # . # # . # # . # # . # # . # # . # # . # # . # # . # # . # # . # # . # # . # # . # # . # # . # # . # # . # # . # # . # # . #
# # . # # . # # . # # . # . # . # . # . # . # . # . # . # . # . # . # . # . # . # . # . # . # . # . # . . . . . . . . . . . . . . . . . . . . . . . . . . . . . . . . . . . . . . . . . . . . . . . . . . . . . . . . . . . . . . . . . . . . . . . . . . . . . . . . . . . . . . . . . . . . . . . . . . # # . # # . # # . # # . # # . # # . # # . # # . # # . # # . # # . # # . # # . # # . # # . # # . # # . # # . # # . # # . # # . # # . # # . # # . # # . # # . # # . # # . # # . #
# # . # # . # # . # # . # . # . # . # . # . # . # . # . # . # . # . # . # . # . # . # . # . # . # . # . . . . . . . . . . . . . . . . . . . . . . . . . . . . . . . . . . . . . . . . . . . . . . . . . . . . . . . . . . . . . . . . . . . . . . . . . . . . . . . . . . . . . . . . . . . . . . . . . . # # . # # . # # . # # . # # . # # . # # . # # . # # . # # . # # . # # . # # . # # . # # . # # . # # . # # . # # . # # . # # . # # . # # . # # . # # . # # . # # . # # . # # . #
# # . # # . # # . # # . # . # . # . # . # . # . # . # . # . # . # . # . # . # . # . # . # . # . # . # . . . . . . . . . . . . . . . . . . . . . . . . . . . . . . . . . . . . . . . . . . . . . . . . . . . . . . . . . . . . . . . . . . . . . . . . . . . . . . . . . . . . . . . . . . . . . . . . . . # # . # # . # # . # # . # # . # # . # # . # # . # # . # # . # # . # # . # # . # # . # # . # # . # # . # # . # # . # # . # # . # # . # # . # # . # # . # # . # # . # # . # # . #
# # . # # . # # . # # . # . # . # . # . # . # . # . # . # . # . # . # . # . # . # . # . # . # . # . # . . . . . . . . . . . . . . . . . . . . . . . . . . . . . . . . . . . . . . . . . . . . . . . . . . . . . . . . . . . . . . . . . . . . . . . . . . . . . . . . . . . . . . . . . . . . . . . . . . # # . # # . # # . # # . # # . # # . # # . # # . # # . # # . # # . # # . # # . # # . # # . # # . # # . # # . # # . # # . # # . # # . # # . # # . # # . # # . # # . # # . # # . #
# # . # # . # # . # # . # . # . # . # . # . # . # . # . # . # . # . # . # . # . # . # . # . # . # . # . . . . . . . . . . . . . . . . . . . . . . . . . . . . . . . . . . . . . . . . . . . . . . . . . . . . . . . . . . . . . . . . . . . . . . . . . . . . . . . . . . . . . . . . . . . . . . . . . . # # . # # . # # . # # . # # . # # . # # . # # . # # . # # . # # . # # . # # . # # . # # . # # . # # . # # . # # . # # . # # . # # . # # . # # . # # . # # . # # . # # . # # . #
# # . # # . # # . # # . # . # . # . # . # . # . # . # . # . # . # . # . # . # . # . # . # . # . # . # . . . . . . . . . . . . . . . . . . . . . . . . . . . . . . . . . . . . . . . . . . . . . . . . . . . . . . . . . . . . . . . . . . . . . . . . . . . . . . . . . . . . . . . . . . . . . . . . . . # # . # # . # # . # # . # # . # # . # # . # # . # # . # # . # # . # # . # # . # # . # # . # # . # # . # # . # # . # # . # # . # # . # # . # # . # # . # # . # # . # # . # # . #
. . . . . . . . . . . . . . . . . . . . . . . . . . . . . . . . . . . . . . . . . . . . . . . . . . . . . . . . . . . . . . . . . . . . . . . . . . . . . . . . . . . . . . . . . . . . . . . . . . . . . . . . . . . . . . . . . . . . . . . . . . . . . . . . . . . . . . . . . . . . . . . . . . . . . . . . . . . . . . . . . . . . . . . . . . . . . . . . . . . . . . . . . . . . . . . . . . . . . . . . . . . . . . . . . . . . . . . . . . . . . . . . . . . . . . . . . . . . .
# # . # # . # # . # # . # # . # # . # # . # # . # # . # # . # # . . . . # # . # # . # # . # # . # # . # # . # # . # # . . . . # # . # # . # # . # # . # # . # # . # # . # # . # # . . . # # . # # . # # . # # . # # . # # . # # . # # . # # . # # . # # . # # . # # . # # . # # . # # . # # . # # . # # . # # . # # . # # . # # . # # . # # . # # . # # . # # . # # . # # . # # . # # . # # . # # . # # . # # . # # . # # . # # . # # . # # . # # . # # . # # . # # . # # . # # . # # . #
# # . # # . # # . # # . # # . # # . # # . # # . # # . # # . # # . . . . # # . # # . # # . # # . # # . # # . # # . # # . . . . # # . # # . # # . # # . # # . # # . # # . # # . # # . . . # # . # # . # # . # # . # # . # # . # # . # # . # # . # # . # # . # # . # # . # # . # # . # # . # # . # # . # # . # # . # # . # # . # # . # # . # # . # # . # # . # # . # # . # # . # # . # # . # # . # # . # # . # # . # # . # # . # # . # # . # # . # # . # # . # # . # # . # # . # # . # # . #
# # . # # . # # . # # . # # . # # . # # . # # . # # . # # . # # . . . . # # . # # . # # . # # . # # . # # . # # . # # . . . . # # . # # . # # . # # . # # . # # . # # . # # . # # . . . # # . # # . # # . # # . # # . # # . # # . # # . # # . # # . # # . # # . # # . # # . # # . # # . # # . # # . # # . # # . # # . # # . # # . # # . # # . # # . # # . # # . # # . # # . # # . # # . # # . # # . # # . # # . # # . # # . # # . # # . # # . # # . # # . # # . # # . # # . # # . # # . #
# # . # # . # # . # # . # # . # # . # # . # # . # # . # # . # # . . . . # # . # # . # # . # # . # # . # # . # # . # # . . . . # # . # # . # # . # # . # # . # # . # # . # # . # # . . . # # . # # . # # . # # . # # . # # . # # . # # . # # . # # . # # . # # . # # . # # . # # . # # . # # . # # . # # . # # . # # . # # . # # . # # . # # . # # . # # . # # . # # . # # . # # . # # . # # . # # . # # . # # . # # . # # . # # . # # . # # . # # . # # . # # . # # . # # . # # . # # . #
# # . # # . # # . # # . # # . # # . # # . # # . # # . # # . # # . . . . # # . # # . # # . # # . # # . # # . # # . # # . . . . # # . # # . # # . # # . # # . # # . # # . # # . # # . . . # # . # # . # # . # # . # # . # # . # # . # # . # # . # # . # # . # # . # # . # # . # # . # # . # # . # # . # # . # # . # # . # # . # # . # # . # # . # # . # # . # # . # # . # # . # # . # # . # # . # # . # # . # # . # # . # # . # # . # # . # # . # # . # # . # # . # # . # # . # # . # # . #
# # . # # . # # . # # . # # . # # . # # . # # . # # . # # . # # . . . . # # . # # . # # . # # . # # . # # . # # . # # . . . . # # . # # . # # . # # . # # . # # . # # . # # . # # . . . # # . # # . # # . # # . # # . # # . # # . # # . # # . # # . # # . # # . # # . # # . # # . # # . # # . # # . # # . # # . # # . # # . # # . # # . # # . # # . # # . # # . # # . # # . # # . # # . # # . # # . # # . # # . # # . # # . # # . # # . # # . # # . # # . # # . # # . # # . # # . # # . #
# # . # # . # # . # # . # # . # # . # # . # # . # # . # # . # # . . . . # # . # # . # # . # # . # # . # # . # # . # # . . . . # # . # # . # # . # # . # # . # # . # # . # # . # # . . . # # . # # . # # . # # . # # . # # . # # . # # . # # . # # . # # . # # . # # . # # . # # . # # . # # . # # . # # . # # . # # . # # . # # . # # . # # . # # . # # . # # . # # . # # . # # . # # . # # . # # . # # . # # . # # . # # . # # . # # . # # . # # . # # . # # . # # . # # . # # . # # . #
# # . # # . # # . # # . # # . # # . # # . # # . # # . # # . # # . . . . # # . # # . # # . # # . # # . # # . # # . # # . . . . # # . # # . # # . # # . # # . # # . # # . # # . # # . . . # # . # # . # # . # # . # # . # # . # # . # # . # # . # # . # # . # # . # # . # # . # # . # # . # # . # # . # # . # # . # # . # # . # # . # # . # # . # # . # # . # # . # # . # # . # # . # # . # # . # # . # # . # # . # # . # # . # # . # # . # # . # # . # # . # # . # # . # # . # # . # # . #
. . . . . . . . . . . . . . . . . . . . . . . . . . . . . . . . . . . . . . . . . . . . . . . . . . . . . . . . . . . . . . . . . . . . . . . . . . . . . . . . . . . . . . . . . . . . . . . . . . . . . . . . . . . . . . . . . . . . . . . . . . . . . . . . . . . . . . . . . . . . . . . . . . . . . . . . . . . . . . . . . . . . . . . . . . . . . . . . . . . . . . . . . . . . . . . . . . . . . . . . . . . . . . . . . . . . . . . . . . . . . . . . . . . . . . . . . . . . .
. . . . . . . . . . . . . . . . . . . . . . . . . . . . . . . . . . . . . . . . . . . . . . . . . . . . . . . . . . . . . . . . . . . . . . . . . . . . . . . . . . . . . . . . . . . . . . . . . . . . . . . . . . . . . . . . . . . . . . . . . . . . . . . . . . . . . . . . . . . . . . . . . . . . . . . . . . . . . . . . . . . . . . . . . . . . . . . . . . . . . . . . . . . . . . . . . . . . . . . . . . . . . . . . . . . . . . . . . . . . . . . . . . . . . . . . . . . . .
# # . # # . # # . # # . # # . # # . # # . # # . # # . # # . # # . . . . # # . # # . # # . # # . # # . # # . # # . # # . . . . # # . # # . # # . # # . # # . # # . # # . # # . # # . . . # # . # # . # # . # # . # # . # # . # # . # # . # # . # # . # # . # # . # # . # # . # # . # # . # # . # # . # # . # # . # # . # # . # # . # # . # # . # # . # # . # # . # # . # # . # # . # # . # # . # # . # # . # # . # # . # # . # # . # # . # # . # # . # # . # # . # # . # # . # # . # # . #
# # . # # . # # . # # . # # . # # . # # . # # . # # . # # . # # . . . . # # . # # . # # . # # . # # . # # . # # . # # . . . . # # . # # . # # . # # . # # . # # . # # . # # . # # . . . # # . # # . # # . # # . # # . # # . # # . # # . # # . # # . # # . # # . # # . # # . # # . # # . # # . # # . # # . # # . # # . # # . # # . # # . # # . # # . # # . # # . # # . # # . # # . # # . # # . # # . # # . # # . # # . # # . # # . # # . # # . # # . # # . # # . # # . # # . # # . # # . #
# # . # # . # # . # # . # # . # # . # # . # # . # # . # # . # # . . . . # # . # # . # # . # # . # # . # # . # # . # # . . . . # # . # # . # # . # # . # # . # # . # # . # # . # # . . . # # . # # . # # . # # . # # . # # . # # . # # . # # . # # . # # . # # . # # . # # . # # . # # . # # . # # . # # . # # . # # . # # . # # . # # . # # . # # . # # . # # . # # . # # . # # . # # . # # . # # . # # . # # . # # . # # . # # . # # . # # . # # . # # . # # . # # . # # . # # . # # . #
# # . # # . # # . # # . # # . # # . # # . # # . # # . # # . # # . . . . # # . # # . # # . # # . # # . # # . # # . # # . . . . # # . # # . # # . # # . # # . # # . # # . # # . # # . . . # # . # # . # # . # # . # # . # # . # # . # # . # # . # # . # # . # # . # # . # # . # # . # # . # # . # # . # # . # # . # # . # # . # # . # # . # # . # # . # # . # # . # # . # # . # # . # # . # # . # # . # # . # # . # # . # # . # # . # # . # # . # # . # # . # # . # # . # # . # # . # # . #
# # . # # . # # . # # . # # . # # . # # . # # . # # . # # . # # . . . . # # . # # . # # . # # . # # . # # . # # . # # . . . . # # . # # . # # . # # . # # . # # . # # . # # . # # . . . # # . # # . # # . # # . # # . # # . # # . # # . # # . # # . # # . # # . # # . # # . # # . # # . # # . # # . # # . # # . # # . # # . # # . # # . # # . # # . # # . # # . # # . # # . # # . # # . # # . # # . # # . # # . # # . # # . # # . # # . # # . # # . # # . # # . # # . # # . # # . # # . #
# # . # # . # # . # # . # # . # # . # # . # # . # # . # # . # # . . . . # # . # # . # # . # # . # # . # # . # # . # # . . . . # # . # # . # # . # # . # # . # # . # # . # # . # # . . . # # . # # . # # . # # . # # . # # . # # . # # . # # . # # . # # . # # . # # . # # . # # . # # . # # . # # . # # . # # . # # . # # . # # . # # . # # . # # . # # . # # . # # . # # . # # . # # . # # . # # . # # . # # . # # . # # . # # . # # . # # . # # . # # . # # . # # . # # . # # . # # . #
# # . # # . # # . # # . # # . # # . # # . # # . # # . # # . # # . . . . # # . # # . # # . # # . # # . # # . # # . # # . . . . # # . # # . # # . # # . # # . # # . # # . # # . # # . . . # # . # # . # # . # # . # # . # # . # # . # # . # # . # # . # # . # # . # # . # # . # # . # # . # # . # # . # # . # # . # # . # # . # # . # # . # # . # # . # # . # # . # # . # # . # # . # # . # # . # # . # # . # # . # # . # # . # # . # # . # # . # # . # # . # # . # # . # # . # # . # # . #
# # . # # . # # . # # . # # . # # . # # . # # . # # . # # . # # . . . . # # . # # . # # . # # . # # . # # . # # . # # . . . . # # . # # . # # . # # . # # . # # . # # . # # . # # . . . # # . # # . # # . # # . # # . # # . # # . # # . # # . # # . # # . # # . # # . # # . # # . # # . # # . # # . # # . # # . # # . # # . # # . # # . # # . # # . # # . # # . # # . # # . # # . # # . # # . # # . # # . # # . # # . # # . # # . # # . # # . # # . # # . # # . # # . # # . # # . # # . #
# # . # # . # # . # # . # # . # # . # # . # # . # # . # # . # # . . . . # # . # # . # # . # # . # # . # # . # # . # # . . . . # # . # # . # # . # # . # # . # # . # # . # # . # # . . . # # . # # . # # . # # . # # . # # . # # . # # . # # . # # . # # . # # . # # . # # . # # . # # . # # . # # . # # . # # . # # . # # . # # . # # . # # . # # . # # . # # . # # . # # . # # . # # . # # . # # . # # . # # . # # . # # . # # . # # . # # . # # . # # . # # . # # . # # . # # . # # . #
# # . # # . # # . # # . # # . # # . # # . # # . # # . # # . # # . . . . # # . # # . # # . # # . # # . # # . # # . # # . . . . # # . # # . # # . # # . # # . # # . # # . # # . # # . . . # # . # # . # # . # # . # # . # # . # # . # # . # # . # # . # # . # # . # # . # # . # # . # # . # # . # # . # # . # # . # # . # # . # # . # # . # # . # # . # # . # # . # # . # # . # # . # # . # # . # # . # # . # # . # # . # # . # # . # # . # # . # # . # # . # # . # # . # # . # # . # # . #
# # . # # . # # . # # . # # . # # . # # . # # . # # . # # . # # . . . . # # . # # . # # . # # . # # . # # . # # . # # . . . . # # . # # . # # . # # . # # . # # . # # . # # . # # . . . # # . # # . # # . # # . # # . # # . # # . # # . # # . # # . # # . # # . # # . # # . # # . # # . # # . # # . # # . # # . # # . # # . # # . # # . # # . # # . # # . # # . # # . . . . . . . . . . . . . . . . . . . . . . . . . . . . . . . . . . . . . . . . . . . . . . . . . . . . . . . . . . .
# # . # # . # # . # # . # # . # # . # # . # # . # # . # # . # # . . . . # # . # # . # # . # # . # # . # # . # # . # # . . . . # # . # # . # # . # # . # # . # # . # # . # # . # # . . . # # . # # . # # . # # . # # . # # . # # . # # . # # . # # . # # . # # . # # . # # . # # . # # . # # . # # . # # . # # . # # . # # . # # . # # . # # . # # . # # . # # . # # . . . . . . . . . . . . . . . . . . . . . . . . . . . . . . . . . . . . . . . . . . . . . . . . . . . . . . . . . . .
. . . . . . . . . . . . . . . . . . . . . . . . . . . . . . . . . . . . . . . . . . . . . . . . . . . . . . . . . . . . . . . . . . . . . . . . . . . . . . . . . . . . . . . . . . . . . . . . . . . . . . . . . . . . . . . . . . . . . . . . . . . . . . . . . . . . . . . . . . . . . . . . . . . . . . . . . . . . . . . . . . . . . . . . . . . . . . . . . . . . . . . . . . . . . . . . . . . . . . . . . . . . . . . . . . . . . . . . . . . . . . . . . . . . . . . . . . . . .
. . . . . . . . . . . . . . . . . . . . . . . . . . . . . . . . . . . . . . . . . . . . . . . . . . . . . . . . . . . . . . . . . . . . . . . . . . . . . . . . . . . . . . . . . . . . . . . . . . . . . . . . . . . . . . . . . . . . . . . . . . . . . . . . . . . . . . . . . . . . . . . . . . . . . . . . . . . . . . . . . . . . . . . . . . . . . . . . . . . . . . . . . . . . . . . . . . . . . . . . . . . . . . . . . . . . . . . . . . . . . . . . . . . . . . . . . . . . .
. . . . . . . . . . . . . . . . . . . . . . . . . . . . . . . . . . . . . . . . . . . . . . . . . . . . . . . . . . . . . . . . . . . . . . . . . . . . . . . . . . . . . . . . . . . . . . . . . . . . . . . . . . . . . . . . . . . . . . . . . . . . . . . . . . . . . . . . . . . . . . . . . . . . . . . . . . . . . . . . . . . . . . . . . . . . . . . . . . . . . . . . . . . . . . . . . . . . . . . . . . . . . . . . . . . . . . . . . . . . . . . . . . . . . . . . . . . . .
# # . # # . # # . # # . # # . # # . # # . # # . # # . # # . # # . . . . # # . # # . # # . # # . # # . # # . # # . # # . . . . # # . # # . # # . # # . # # . # # . # # . # # . # # . . . # # . # # . # # . # # . # # . # # . # # . # # . # # . # # . . . . # # . # # . # # . # # . # # . # # . # # . # # . # # . # # . # # . # # . # # . # # . # # . # # . # # . # # . . . . . . . . . . . . . . . . . . . . . . . . . . . . . . . . . . . . . . . . . . . . . . . . . . . . . . . . . . .
# # . # # . # # . # # . # # . # # . # # . # # . # # . # # . # # . . . . # # . # # . # # . # # . # # . # # . # # . # # . . . . # # . # # . # # . # # . # # . # # . # # . # # . # # . . . # # . # # . # # . # # . # # . # # . # # . # # . # # . # # . . . . # # . # # . # # . # # . # # . # # . # # . # # . # # . # # . # # . # # . # # . # # . # # . # # . # # . # # . . . . . . . . . . . . . . . . . . . . . . . . . . . . . . . . . . . . . . . . . . . . . . . . . . . . . . . . . . .
# # . # # . # # . # # . # # . # # . # # . # # . # # . # # . # # . . . . # # . # # . # # . # # . # # . # # . # # . # # . . . . # # . # # . # # . # # . # # . # # . # # . # # . # # . . . # # . # # . # # . # # . # # . # # . # # . # # . # # . # # . . . . # # . # # . # # . # # . # # . # # . # # . # # . # # . # # . # # . # # . # # . # # . # # . # # . # # . # # . . . . . . . . . . . . . . . . . . . . . . . . . . . . . . . . . . . . . . . . . . . . . . . . . . . . . . . . . . .
# # . # # . # # . # # . # # . # # . # # . # # . # # . # # . # # . . . . # # . # # . # # . # # . # # . # # . # # . # # . . . . # # . # # . # # . # # . # # . # # . # # . # # . # # . . . # # . # # . # # . # # . # # . # # . # # . # # . # # . # # . . . . # # . # # . # # . # # . # # . # # . # # . # # . # # . # # . # # . # # . # # . # # . # # . # # . # # . # # . # # . # # . . . . # # . # # . # # . # # . # . . . . . # # . # # . # # . # # . # # . # # . # # . # # . # # . # # . #
# # . # # . # # . # # . # # . # # . # # . # # . # # . # # . # # . . . . # # . # # . # # . # # . # # . # # . # # . # # . . . . # # . # # . # # . # # . # # . # # . # # . # # . # # . . . # # . # # . # # . # # . # # . # # . # # . # # . # # . # # . . . . # # . # # . # # . # # . # # . # # . # # . # # . # # . # # . # # . # # . # # . # # . # # . # # . # # . # # . # # . # # . . . . # # . # # . # # . # # . # . . . . . # # . # # . # # . # # . # # . # # . # # . # # . # # . # # . #
# # . # # . # # . # # . # # . # # . # # . # # . # # . # # . # # . . . . # # . # # . # # . # # . # # . # # . # # . # # . . . . # # . # # . # # . # # . # # . # # . # # . # # . # # . . . # # . # # . # # . # # . # # . # # . # # . # # . # # . # # . . . . # # . # # . # # . # # . # # . # # . # # . # # . # # . # # . # # . # # . # # . # # . # # . # # . # # . # # . # # . # # . . . . # # . # # . # # . # # . # . . . . . # # . # # . # # . # # . # # . # # . # # . # # . # # . # # . #
# # . # # . # # . # # . # # . # # . # # . # # . # # . # # . # # . . . . # # . # # . # # . # # . # # . # # . # # . # # . . . . # # . # # . # # . # # . # # . # # . # # . # # . # # . . . # # . # # . # # . # # . # # . # # . # # . # # . # # . # # . . . . # # . # # . # # . # # . # # . # # . # # . # # . # # . # # . # # . # # . # # . # # . # # . # # . # # . # # . # # . # # . . . . # # . # # . # # . # # . # . . . . . # # . # # . # # . # # . # # . # # . # # . # # . # # . # # . #
# # . # # . # # . # # . # # . # # . # # . # # . # # . # # . # # . . . . # # . # # . # # . # # . # # . # # . # # . # # . . . . # # . # # . # # . # # . # # . # # . # # . # # . # # . . . # # . # # . # # . # # . # # . # # . # # . # # . # # . # # . . . . # # . # # . # # . # # . # # . # # . # # . # # . # # . # # . # # . # # . # # . # # . # # . # # . # # . # # . # # . # # . . . . # # . # # . # # . # # . # . . . . . # # . # # . # # . # # . # # . # # . # # . # # . # # . # # . #
# # . # # . # # . # # . # # . # # . # # . # # . # # . # # . # # . . . . # # . # # . # # . # # . # # . # # . # # . # # . . . . # # . # # . # # . # # . # # . # # . # # . # # . # # . . . # # . # # . # # . # # . # # . # # . # # . # # . # # . # # . . . . # # . # # . # # . # # . # # . # # . # # . # # . # # . # # . # # . # # . # # . # # . # # . # # . # # . # # . # # . # # . . . . # # . # # . # # . # # . # . . . . . # # . # # . # # . # # . # # . # # . # # . # # . # # . # # . #
# # . # # . # # . # # . # # . # # . # # . # # . # # . # # . # # . . . . # # . # # . # # . # # . # # . # # . # # . # # . . . . # # . # # . # # . # # . # # . # # . # # . # # . # # . . . # # . # # . # # . # # . # # . # # . # # . # # . # # . # # . . . . . . . # # . # # . # # . # # . # # . # # . # # . # # . # # . # # . # # . # # . # # . # # . # # . # # . # # . # # . # # . . . . # # . # # . # # . # # . # . . . . . # # . # # . # # . # # . # # . # # . # # . # # . # # . # # . #
# # . # # . # # . # # . # # . # # . # # . # # . # # . # # . # # . . . . # # . # # . # # . # # . # # . # # . # # . # # . . . . # # . # # . # # . # # . # # . # # . # # . # # . # # . . . # # . # # . # # . # # . # # . # # . # # . # # . # # . . . . . . . . . . . . . # # . # # . # # . # # . # # . # # . # # . # # . # # . # # . # # . # # . # # . # # . # # . # # . # # . # # . . . . # # . # # . # # . # # . # . . . . . # # . # # . # # . # # . # # . # # . # # . # # . # # . # # . .